acerbic = (especially of a comment or style of speaking) sharp and forthright
advisor = a person who gives advice, typically someone who is expert in a particular field
alleviate = make (something bad or unsatisfactory) better
aloof = not friendly or forthcoming; cool and distant
ameliorate = make (something bad or unsatisfactory) better
amorous = showing, feeling, or relating to sexual desire
argument = an exchange of diverging or opposite views, typically a heated or angry one
ascertain = find (something) out for certain; make sure of
austerity = ternness or severity of manner or attitude
bibliographical = a list of the written sources of information on a subject
bogus = not genuine or true; fake
boisterous = (of a person, event, or behavior) noisy, energetic, and cheerful
bolster = support or strengthen; prop up
complementary = combining in such a way as to enhance or emphasize the qualities of each other or another
concisely = expressing or covering much in few words
conference = a formal meeting for discussion
confession = a formal statement admitting that one is guilty of a crime
consistent = (of a person, behavior, or process) unchanging in achievement or effect over a period of time
conspiracy = a secret plan by a group to do something unlawful or harmful
constitution = a body of fundamental principles or established precedents according to which a state or other organization is acknowledged to be governed
contemporary = living or occurring at the same time
conventional = conforming to a standard; usual, typical, or expected
conversation = the informal exchange of ideas by spoken words
critical = very attentive to and concerned about accuracy and detail
criticism = of, relating to, or involving strongly critical, controversial, or disputatious writing or speech
curiosity = a strong desire to know or learn something novel
cursory = hasty and therefore not thorough or detailed
delicious = highly pleasant to the taste
delightful = pleasing in general; delightful
deteriorate = become progressively worse
dialogue = the informal exchange of ideas by spoken words
diffidence = modesty or shyness resulting from a lack of self-confidence
eccentric = (of a person or their behavior) unconventional and slightly strange
effective = successful in producing a desired or intended result
eminence = fame or recognized superiority, especially within a particular sphere or profession
endeavor = try hard to do or achieve something
engage = occupy, attract, or involve (someone's interest or attention)
enthusiasm = intense and eager enjoyment, interest, or approval
exacerbate = make (a problem, bad situation, or negative feeling) worse
executive = having the power to put plans, actions, or laws into effect
fanciful = (of a person or their thoughts and ideas) overimaginative and unrealistic
fastidious = very attentive to and concerned about accuracy and detail
fierce = having or displaying an intense or ferocious aggressiveness
fortuitous = happening by accident or chance rather than design
fresh = not previously known or used; new or different
frugality = the quality of being economical with money or food
galaxy = a system of millions or billions of stars, together with gas and dust, held together by gravitational attraction
hard = solid, firm, and resistant to pressure; not easily broken, bent, or pierced
hostess = a woman who is employed to provide meals for and otherwise look after the passengers on a ship or aircraft
indecorous = not in keeping with good taste and propriety
interest = a strong desire to know or learn something
majesty = impressive stateliness
meticulous = howing great attention to detail; very careful and precise
mitigate = make (something bad or unsatisfactory) better
mysterious = difficult or impossible to understand, explain, or identify
normal = conforming to a standard; usual, typical, or expected
notoriety = the state of being famous or well known for some bad quality or deed
obsolete = no longer produced or used; out of date
orthodox = (of a person or their views, especially religious or political ones, or other beliefs or practices) conforming to what is generally or traditionally accepted as right or true; established and approved
overshadow = tower above and cast a shadow over
passionate = showing or caused by strong feelings or a strong belief
pellucid = translucently clear
placid = (of a person or animal) not easily upset or excited
polemical = of, relating to, or involving strongly critical, controversial, or disputatious writing or speech
precarious = not securely held or in position; dangerously likely to fall or collapse
prolixity = extended to great, unnecessary, or tedious length
prophetic = accurately describing or predicting what will happen in the future
rational = based on or in accordance with reason or logic
reference = the action of mentioning or alluding to something
research = the systematic investigation into and study of materials and sources in order to establish facts and reach new conclusions
restive = (of a person) unable to keep still or silent and becoming increasingly difficult to control, especially because of impatience, dissatisfaction, or boredom
skittish = (of a person) unable to keep still or silent and becoming increasingly difficult to control, especially because of impatience, dissatisfaction, or boredom
stewardess = a woman who is employed to provide meals for and otherwise look after the passengers on a ship or aircraft
stinginess = reluctant to part with money or goods
sweet = pleasing in general; delightful
taciturnity = the trait of reticence, of seeming aloof and uncommunicative
tasty = highly pleasant to the taste
temperance = abstinence from alcoholic drink
tolerance = the ability or willingness to tolerate something, in particular the existence of opinions or behavior that one does not necessarily agree with
tumultuous = making a loud, confused noise
typical = conforming to a standard; usual, typical, or expected
virtual = almost or nearly as described, but not completely or according to strict definition
volubility = the quality of talking fluently, readily, or incessantly
yummy = highly pleasant to the taste
